One Cost Units (7):

Rosehip Ranger (Fruitful Forces) - kogmaw
Ceylon Centurion (Black Brigade) - garen
Rainforest Recruit (Herbal Heroes) - kobuko
Green Genie (Green Guardians) - ahri
Darjeeling Defender (Aromatic Avatars) - Malphite
Cardamom Castellan (Aromatic Avatars) - jax
Assam Archer (Black Brigade) - caitlyn

Two Cost Units (7):

Hibiscus Herald (Floral Fighters) - Janna
Earl Grey Explorer (Black Brigade) - teemo
Lavender Lancer (Herbal Heroes) - qiyana
Oolong Occultist (Exotic Enchanters) - zyra
Rooibos Ritter (Fruitful Forces) - Shen
Cascara Champion (Aromatic Avatars) - Aatrox
Matcha Marksman (Green Guardians) - kindred

Three Cost Units (6):

Peppermint Pugilist (Herbal Heroes) - yone
Saffron Sorcerer (Exotic Enchanters) - soraka
Jasmine Jouster (Floral Fighters) - illaoi
Chai Cyclops (Black Brigade) - voli
White Whisperer (Aromatic Avatars) - alune
Mint Mage (Green Guardians) - zoe

Four Cost Units (6):

Pu'erh Paladin (Black Brigade) - galio
Dragonfruit Druid (Exotic Enchanters) - Lillia
Vanilla Valkyrie (Floral Fighters) - kaisa
Chamomile Charger (Herbal Heroes) - sylas
Ginseng Guardian (Fruitful Forces) - Nautilus
Sencha Samurai (Green Guardians) - Kayn

Five Cost Units (4):

Peony Phoenix (Floral Fighters) - lissandra
Elderberry Enchanter (Fruitful Forces) - azir
Bergamot Berserker (Aromatic Avatars) - udyr
Verbena Vampire (Herbal Heroes) - irelia


ff: purple
bb: dark
herb: red-brown
green: green
aromatic: yellow
floral: soft light colors
ee: 
